1111111111111
10000C00000C1
1000000000001
1P000C00000E1
1111111111111